ahhhhhthhhthhhb
v     v   v   v
uhhhb chb i f v
v   v   v   v v
v ghwhb chthd v
v     v   v   v
v ghb chb i f v
v   v   v   v v
uhe v ahwhhhx v
v   v v     v v
v ahx v f ghx v
v v v v v   v v
v i v i chb i v
v   v     v   v
chhhwhhhhhwhhhd
