###########################################################################################
#   #   # # # # #     #         #   # # # #   # # # # # # #             # #   # # #   # # #
### # # # # # # # ##### ##### ### ### # # # ### # # # # # # ########### # # ### # # ### # #
#     # # #   # # # # #   #     #   # # # # #               #         #     # # #         #
# # ##### # ### # # # ### ####### ### # # # ### # ### # # # # # # # # ### # # # # ### ### #
# # # #                         # #     # # #   # # # # # #   # # # #   # #         #   # #
### # # ### ### # # # ### # # # # # ##### # # ##### # # # ##### # ##### ### ### # # # #####
#         #   # # # # #   # # #               # #   # # #     # # # #     #   # # # #     #
# # ##### # ####### # ##### # ### ##### # # ### # ##### # ### ### # ############### #######
# # #     #   # #   #     # #   #     # # #           # # #     #       # # # # # #     # #
### ####### # # ### # # # ######### ##### ### # # ### # ##### ### ####### # # # # # ##### #
#   # #     #     # # # #   #     #     #   # # #   # # #       # # #   # # #     # # #   #
# # # ####### # # # ### # ### ####### # # # # ### # ##### ### ##### # ### # # # ##### ### #
# #     # # # # # # #   #           # # # # #   # #     # # #   # # #         #           #
# ####### # ### ### # ### # # ########### ####### # # # ### # # # # # ### ######### # ### #
#     #   # #   # # # #   # # #   #   #     #   # # # #   #   # # # #   # # #     # # #   #
### ### ### ##### # ### # ### # ### # ### ### ##### # # ####### # # # ##### # #############
#                 #   # # #         # # #     #   # # # # # # #       #       #   # # #   #
### # # # # ### ##### ### ### ### ##### ##### # ####### # # # # # ### # ### ### ### # ### #
#   # # # #   # #     #     # # #           # # #   # #     #   #   #     # #   #         #
# # ##### ##### ######### # # # # ####### # ### # # # # # # # ### # # ### ### ### #########
# #     #     # # # #     # # #       # # #       #   # # # # #   # #   # #     #   # #   #
# ##### ##### ### # ### # # # ### ##### ####### # ##### # # # ### # # # ##### ### # # # ###
#   #   #           #   # # #   # # #   # # # # # #   # # # #   # # # #           # # #   #
# ##### ##### # ############# # # # ### # # # ##### # # ##### ### # # # # ### # # ### # ###
# #         # #             # # #     #     #       # # #     #   # # # #   # # #   # #   #
##### ### ### ### ### ### ### # ### ### ##### ### # ####### # ### ### # ##### ### # # # ###
#       # # # #     # # # #   # #             #   # #     # # #   #   #   # #   # #       #
# # # # # # # # # # # # # ##### ### ### ### ##### ### ### ### ### ##### # # # # ###########
# # # # #   # # # # # #       # #   #     # # #     #   # #     # #     #   # #   # # #   #
### # # ##### ### # # ############# ####### # ####### ########### ### ### ### # ### # # # #
# # # # #       # # # # # #   #         #   #         # #   # # # #   #   #   #         # #
# ### # ##### ##### # # # # ####### ### # # ### ### ### # ### # ####### ####### # ####### #
#     #   #       # #           #     # # # # # # #           #   # #   # #     # #   #   #
##### # ##### ##### # # # # ### # # # # # ### # # ### ### # # # ### # ### ### ### ### #####
#     # #     #     # # # #   # # # # # #           # #   # #   #           # #       #   #
### ### ### # ##### ####### # ### ### # # ############### ##### ### ### # ### # ### # ### #
#   # #   # #   #     # #   #   # #   # #   #     #     #     # # # #   # # # # #   #     #
# # # ### # ### ### ### ### # # # ### # # # ### # # ####### ### # ####### # ### ### ##### #
# #   # # #   # #         # # # # #   # # #     #       # # #         #       # #       # #
# ### # # ##### ### # # # # ##### ### # ### # ##### ##### ##### # ####### # # ### ##### # #
# #     #   #   #   # # # #     #   # # #   # #   #           # # #   #   # # #   #     # #
# # # # ### # ### # # # # # ### ### ### ### # ### ####### # ### # # ##### # # # # ### ### #
# # # #   # # # # # # # # #   # #   #     # #     #   # # # # # #     #   # # # #   #   # #
### ### ##### # # ### # ### ### # # # # # ### # ##### # # # # ### # ##### # ####### # #####
#     #     #   # #   # #     # # # # # #   # #   #     # # # #   # # #   #   #   # #     #
### # ##### ######### # # ### # ####### # # # # # # # # ### # ####### ##### ### # #########
#   #     #   #       # #   # # #       # # # # #   # #   #     #   # # #   #   #     # # #
# ##### # ### # # ### ####### # ##### ### ##### ### ####### # # # ### # ##### ### ##### # #
# #     #   # # # #     # #   #   #   # #   # #   #       # # #   #   # #     # #         #
#$##### # # # ##### # # # ######### ### # # # # # ####### ####### # ### ### ### ######### #
#   #   # # # #     # #     # # #   #   # #   # # #       # #   # # #           # # #   # #
# # ### # ### # ##### ### # # # ##### ### ##### # # ##### # ### ### # ##### # ### # ### ###
# #   # # # # # #     #   #           #     #   # # #                   # # #             #
# ### ##### ######### ### # # ######### ### ### # ### ######### # ### ### # ##### # ### ###
#   #       # #       #   # #   #   # #   #   # # # #     #     #   #     #   # # # # # # #
# # ##### # # ####### # ##### ### ### # # ##### ### ### # ### ####### # ####### # # # ### #
# # #     #     #     #   #           # #   #     #   # # #       #   #         # #       #
# # ##### # ####### # # ##### # # # ### # ##### # # # ### ### ####### ### # # ### # ### ###
# # #     #     # # # # #     # # #   # #   #   #   #   # #   #       #   # #   # #   #   #
# ##### ### # ### # ### # ### # ### ##### ##### # ##### ### # ####### # ### ####### ##### #
#     #   # #     # #   # #   #   #     #   #   #     # # # #   #     # #     # #     # # #
# ### ### ### # # ##### ### # ### ### # ############### # ### # ##### ### ### # ####### ###
#   #   # #   # #     # #   #   #   # # # # # #   #   # #     #   #     #   #         # # #
# ### # ##### ### # # # ### ##### # # # # # # # ### ######### ####### # ####### # ### # # #
#   # # #     #   # # # #     #   # # #     #   # #   # #         # # #   # #   #   #     #
# # ### # ####### ### # ####### # # ### ##### ### # ### # ### # # # ####### ### # ####### #
# #   # # #       #   # #       # #   #       # #   #     #   # # # # # # #     #   #   # #
# ##### ### ### ##### # ### ####### # ####### # # # ##### ##### ### # # # # ##### # ### ###
#     #   #   #   #   #   # #       #       #     #   #     #             #   # # #     # #
# ### ##### ### ##### # ########### ### # ### # # ### ### ######### ### ####### # ##### # #
#   #     # #     #   # #             # # #   # #   # # # #     #     #     # #   #       #
# # ####### ### # # ### ### ##### ### ##### # ### # ### ##### ##### ### # ### ### ##### # #
# #       # #   # # #   #   #     #     # # # #   #   # #     # #   #   #       #   #   # #
# ### # ### ### # # ########### # # # # # ### ### ##### # ##### # # ### # # # ### # # ### #
#   # #   #   # # # # #         # # # #     # #       # # # # # # #   # # # #   # # #   # #
# ####### # # ### # # ##### ### # # ### ### ### ##### # # # # # # ### # # # # ### # ### ###
#       # # #   # #   #     #   # # #   #   #   #     # #       # # # # # # #   # # #     #
# ### ##### # ### # # ##### ### # ### ### ### # ##### # # # ####### ##### # # # ### # ### #
#   #     # # #   # # #     #   #   #   # #   # # # #     #           #   # # # # # # #   #
# ##### ### ####### ##### # # # ### ### ### # # # # # ##### ### # # # ### # ##### # #######
#     #   #       #   #   # # #   # #     # # #   #   # # # #   # # #   # #       #     # #
# ######### ####### # ##### ####### # # ##### ### # ### # # ##### ### ##### ### # # ##### #
#         #       # # #       # # # # # #       # # # # #     #   # # # # #   # # #       #
# ### ### ##### # # # # # # ### # # ####### ### ##### # ### ####### # # # ### ### # # ### #
#   #   #     # # # # # # #       #     #   #           #       # #       #   #   # #   # #
# # # ### # ### ##### ##### # ### # # # # ##### # ######### ##### ### # # ######### # ### #
# # #   # #   #     # #     #   # # # # # #     # #     #       # # # # #       # # #   # #
# # # # # # # # ##### ### # # # ### # # ####### # # # # # ### ### # # # ##### # # # # ### #
# # # # # # # #     # #   # # #   # # # #       #   # # #   #       # #   #   #   # #   # #
######################################################################################### #
