###############
#             #
# # # #########
# # #         #
# ##### ### ###
#     #   #   #
# # ##### # # #
# #   #   # # #
# ### # # # ###
#   # # # #   #
# # ### # ### #
# #   # # #   #
### # ##### ###
#   #   #     #
############# #
