###################################
#                   #   # # #     #
### # # # # # ######### # # # ### #
#   # # # # # # # #   # #       # #
# ### ### ##### # ### # # ### #####
#   # #                   # #     #
# # ##### # ### # # # # # # # # ###
# # #   # # #   # # # # #   # #   #
### # # # # ### ### # ### # #######
# #   # # # #     # # # # #     # #
# # ####### # ##### # # # # # # # #
#         # #   #   #   # # # # # #
### ### # ######### # # ##### ### #
#     # #   # # #   # #     #     #
### # # ##### # ##### # # #########
#   # #   # # # # # # # # # #     #
# ### ### # # # # # ####### # #####
# # # #     # #                   #
### # ### ### # ############# # # #
#     #   # #   #         #   # # #
##### ### # # ### ### ########### #
#     #             #     # #   # #
# ### # # # # # # ### ### # # ### #
#   # # # # # # #   #   #       # #
# ### ### ##### # # # ##### # #####
# #   #   #     # # #   # # # #   #
# # ### # ##### # # # ### # ### # #
# # #   # # # # # # #     #     # #
### ### # # # # # # ##### ### # ###
#   #   #   #   # #   # #   # #   #
### ##### ##### ####### ###########
#   #         #         #     # # #
# # ##### # # # ### # # # # ### # #
# # #     # # #   # # #   #       #
################################# #
